CONSOLIDATED	K AH N S AA L AH D EY T AH D
MAGNETIC	M AE G N EH T IH K
MONTE	M AA N T IY
JIHAD	JH IY HH AA D
SLEEP	S L IY P
ASIAN	EY ZH AH N
MANSION	M AE N SH AH N
INTERMINGLE	IH N T ER M IH NG G AH L
HATE	HH EY T
SHAMBLE	SH AE M B AH L
BUDDY	B AH D IY
CABRIOLET	K AE B R IY OW L EY
CABRIOLET(2)	K AE B R IY OW L EH T
ELECTRICITY	IH L EH K T R IH S AH T IY
TWEET	T W IY T
TWEEN	T W IY N
HANDSHAKE	HH AE N D SH EY K
SWAP	S W AA P
DAZE	D EY Z
ALPHABETIC	AE L F AH B EH T IH K
RECYCLE	R IY S AY K AH L
SITUATIONAL	S IH CH UW EY SH AH N AH L
RANCOCAS	R AE NG K AH K AH Z
DIGIT	D IH JH AH T
DIGIT(2)	D IH JH IH T
HORMONE	HH AO R M OW N
EVACUATION	IH V AE K Y AH W EY SH AH N
EVACUATION(2)	IY V AE K Y AH W EY SH AH N
SMACK	S M AE K
MANIA	M EY N IY AH
LEGGINGS	L EH G IH NG Z
JACK	JH AE K
CONFETTI	K AH N F EH T IY
AFFECT	AH F EH K T
MONTH	M AH N TH
SMOG	S M AA G
DISTURB	D IH S T ER B
WOODEN	W UH D AH N
CAUSE	K AA Z
CAUSE(2)	K AO Z
LONELINESS	L OW N L IY N AH S
UPLOAD	AH P L OW D
NIGGER	N IH G ER
MONOLOGUE	M AA N AH L AO G
TRIUMPH	T R AY AH M F
BICYCLE	B AY S IH K AH L
TIRED	T AY ER D
MILLER	M IH L ER
JAPANESE	JH AE P AH N IY Z
SECOND	S EH K AH N D
STREET	S T R IY T
BLUE	B L UW
CALCIUM	K AE L S IY AH M
NED	N EH D
CORPORATION	K AO R P ER EY SH AH N
ASIA	EY ZH AH
HAZE	HH EY Z
INSINUATE	IH N S IH N Y UW EY T
RESILIENT	R IH Z IH L Y AH N T
NEW	N UW
NEW(2)	N Y UW
NET	N EH T
IPOD	AY P AO D
DISNEY	D IH Z N IY
TOLD	T OW L D
WIDGET	W IH JH IH T
CENTRIC	S EH N T R IH K
MEN	M EH N
MEH	M IY
CONGLOMERATE	K AH N G L AA M ER AH T
CHINA	CH AY N AH
PATH	P AE TH
EPIGENESIS	EH P AH JH IY N AH S AH S
GERRY	JH EH R IY
WAKARUSA	W AE K AH R UW S AH
ECONOMICS	EH K AH N AA M IH K S
ECONOMICS(2)	IY K AH N AA M IH K S
MANNERISM	M AE N ER IH Z AH M
BRO	B R OW
CONTROVERSY	K AA N T R AH V ER S IY
JOGGING	JH AA G IH NG
JOGGING(2)	JH AO G IH NG
LOOP	L UW P
SMOKE	S M OW K
FANTASTIC	F AE N T AE S T IH K
MAGICALLY	M AE JH IH K AH L IY
MAGICALLY(2)	M AE JH IH K L IY
SPOOKY	S P UW K IY
SERIALIZE	S IH R IY AH L AY Z
REAGAN	R EY G AH N
REAGAN(2)	R IY G AH N
COUNTY	K AW N T IY
COUNTY(2)	K AW N IY
UNIX	Y UW N IH K S
INSTA	IH N S T AA
EASTWOOD	IY S T W UH D
LANDSCAPE	L AE N D S K EY P
LANDSCAPE(2)	L AE N S K EY P
SARAH	S EH R AH
PALESTINIAN	P AE L IH S T IH N IY AH N
SWEATER	S W EH T ER
BEETLES	B IY T AH L Z
PLOY	P L OY
NEGATIVE	N EH G AH T IH V
CALI	K AA L IY
CALI(2)	K AE L IY
CALL	K AO L
COMCAST	K AA M K AE S T
TYPO	T AY P OW
SPIKE	S P AY K
INDIANA	IH N D IY AE N AH
TYPE	T AY P
KROGER	K R OW G ER
CALF	K AE F
RELAX	R IH L AE K S
RELAX(2)	R IY L AE K S
WARP	W AO R P
PHONE	F OW N
ADULT	AH D AH L T
ADULT(2)	AE D AH L T
EXCELLENT	EH K S AH L AH N T
WARF	W AO R F
TAMPA	T AE M P AH
NUTRA	N AH T R AH
WORST	W ER S T
WORD	W ER D
WORK	W ER K
GASOLINE	G AE S AH L IY N
KLEPTOCRAT	K L EH P T AH K R AE T
CUDDLE	K AH D AH L
TINDER	T IH N D ER
TRANSPARENCY	T R AE N S P EH R AH N S IY
ENTERTAINER	EH N T ER T EY N ER
ENTERTAINER(2)	EH N ER T EY N ER
MY	M AY
VODKA	V AA D K AH
HARMONIUS	HH AA R M AA N AY AH S
EUTHANASIA	Y UW TH AH N EY ZH AH
EUTHANASIA(2)	Y UW TH AH N EY ZH Y AH
INDIA	IH N D IY AH
PAPARAZZI	P AA P AA R AO Z IY
TITANIUM	T AY T EY N IY AH M
HOE	HH OW
END	EH N D
CONVERSATION	K AA N V ER S EY SH AH N
COMPLAINING	K AH M P L EY N IH NG
TRAVEL	T R AE V AH L
MACHINE	M AH SH IY N
CAPPUCCIONO	K AE P AH K S IY AH N OW
STUPIDITY	S T UW P IH D IH T IY
TOXIN	T AA K S AH N
ANSWER	AE N S ER
ORDINARY	AO R D AH N EH R IY
FUDGE	F AH JH
PIZZA	P IY T S AH
ELIZABETH	IH L IH Z AH B AH TH
ELIZABETH(2)	IH L IH Z AH B IH TH
GLAMOROUS	G L AE M ER AH S
AFTER	AE F T ER
ABDOMEN	AE B D OW M AH N
ABDOMEN(2)	AE B D AH M AH N
LUMP	L AH M P
CHUMP	CH AH M P
PRESIDENT	P R EH Z IH D AH N T
LAP	L AE P
LESBIAN	L EH Z B IY AH N
SIBERIA	S AY B IH R IY AH
CROISSANT	K W AA S AA N T
CROISSANT(2)	K R AH S AA N T
BEDAZZLE	B IH D AE Z AH L
GREEN	G R IY N
ULTIMATE	AH L T AH M AH T
AMBULANCE	AE M B Y AH L AH N S
FAN	F AE N
ATROCITY	AH T R AA S AH T IY
SQUINT	S K W IH N T
HEDGEHOG	HH EH JH HH AA G
FAIRFIELD	F EH R F IY L D
SINGAPOREAN	S IH NG G AH P AO R IY AH N
POPSICLE	P AA P S IH K AH L
JPEG	JH P EH G
NORMATIVITY	N AO R M AH T IH V AH T IY
HIBERNATION	HH AY B ER N EY SH AH N
LONDON	L AH N D AH N
KEYBOARD	K IY B AO R D
RESPONSIVE	R IH S P AA N S IH V
JAPAN	JH AH P AE N
SATISFIES	S AE T IH S F AY Z
ADOLESCENCE	AE D AH L EH S AH N S
ADOLESCENCE(2)	AE D OW L EH S AH N S
DESTROYER	D IH S T R OY ER
PERSONAL	P ER S IH N AH L
REPUDIATE	R IY P Y UW D IY EY T
COFFEE	K AA F IY
COFFEE(2)	K AO F IY
BANG	B AE NG
GIRAFFE	JH ER AE F
BANK	B AE NG K
ALEX	AE L AH K S
OXYGEN	AA K S AH JH AH N
OXYGEN(2)	AA K S IH JH AH N
ALEXIS	AH L EH K S IH S
EXPLODE	IH K S P L OW D
VOLCANO	V AA L K EY N OW
FINANCIAL	F AH N AE N SH AH L
FINANCIAL(2)	F IH N AE N SH AH L
FINANCIAL(3)	F AY N AE N SH AH L
TELESCOPE	T EH L AH S K OW P
HALLWAY	HH AO L W EY
ABUSE	AH B Y UW S
ABUSE(2)	AH B Y UW Z
JUGGLING	JH AH G AH L IH NG
JUGGLING(2)	JH AH G L IH NG
DAWN	D AO N
MOTORIZED	M OW T ER AY Z D
NETWORK	N EH T W ER K
GOD	G AA D
GOB	G AA B
SPARKLE	S P AA R K AH L
JAGERMEISTER	JH AE JH AH R M IY S T AH R
AMETHYST	AE M IH TH IH S T
RESISTOR	R IH Z IH S T ER
PHONICS	F AA N IH K S
INOX	IH N AA K S
REVENGE	R IY V EH N JH
FREE	F R IY
ESTIMATE	EH S T AH M AH T
ESTIMATE(2)	EH S T AH M EY T
MULLET	M AH L AH T
ENORMOUS	IH N AO R M AH S
ENORMOUS(2)	IH N AO R M IH S
ENORMOUS(3)	IY N AO R M AH S
ENORMOUS(4)	IY N AO R M IH S
MANIAC	M EY N IY AE K
CHEMOTACTIC	K EH M AH T AH K T AH K
SUBURBIA	S AH B ER B IY AH
PORTMANTEAU	P AO R T M AE N T IY UW
APP	AE P
SUPPER	S AH P ER
FANTASY	F AE N T AH S IY
FANTASY(2)	F AE N AH S IY
DELICIOUS	D IH L IH SH AH S
ELECTRONIC	IH L EH K T R AA N IH K
BASKETBALL	B AE S K AH T B AO L
SARCASM	S AA R K AE Z AH M
CIRCUMSIZE	S ER K AH M S AY Z
ELEVATOR	EH L AH V EY T ER
FICTION	F IH K SH AH N
DUMBASS	D AH M AE S
TOM	T AA M
HOLLYWOOD	HH AA L IY W UH D
FARMING	F AA R M IH NG
DOGS	D AA G Z
DOGS(2)	D AO G Z
URBAN	ER B AH N
MURDER	M ER D ER
TOOL	T UW L
SWOOSH	S W UW SH
NIRVANA	N IH R V AA N AH
NIRVANA(2)	N ER V AA N AH
DROOL	D R UW L
WARDROBE	W AO R D R OW B
WHITE	W AY T
WHITE(2)	HH W AY T
POSITIVELY	P AA Z AH T IH V L IY
FINITELY	F AY N AY T L IY
ANXIETY	AE NG Z AY AH T IY
TREE	T R IY
ROLEX	R OW L EH K S
MEDLEY	M EH D L IY
EXORCISM	EH K S ER S IH Z AH M
MATTER	M AE T ER
FABULOUS	F AE B Y AH L AH S
MINI	M IH N IY
DONKEY	D AA NG K IY
DONKEY(2)	D AO NG K IY
FASHION	F AE SH AH N
BRONCHITIS	B R AA NG K AY T AH S
BOSTON	B AA S T AH N
BOSTON(2)	B AO S T AH N
DILDO	D IH L D OW
RAT	R AE T
SEMINAR	S EH M AH N AA R
ACADEMIC	AE K AH D EH M IH K
SNOW	S N OW
SNOT	S N AO T
CASUAL	K AE ZH AH W AH L
CHEST	CH EH S T
PANDER	P AE N D ER
EVANGELIST	IH V AE N JH AH L IH S T
EVANGELIST(2)	IY V AE N JH AH L IH S T
OBJECT	AA B JH EH K T
OBJECT(2)	AH B JH EH K T
VICTORIA	V IH K T AO R IY AH
MARIO	M AA R IY OW
ADDICT	AH D IH K T
ADDICT(2)	AE D IH K T
JEAN	JH IY N
MARIA	M ER IY AH
DOH	D OW
EPISODE	EH P IH S OW D
MEDICAL	M EH D AH K AH L
MEDICAL(2)	M EH D IH K AH L
RESPONDER	R IH S P AA N D ER
DOG	D AO G
MUSICAL	M Y UW Z IH K AH L
NINETEENTH	N AY N T IY N TH
CONSUMER	K AH N S UW M ER
ANNOYED	AH N OY D
KRISTEN	K R IH S T AH N
AQUATIC	AH K W AA T IH K
AQUATIC(2)	AH K W AE T IH K
BOMB	B AA M
BOMB(2)	B AO M
HUNGER	HH AH NG G ER
BIMBO	B IH M B OW
PRECARIOUS	P R IY K EH R IY AH S
DRABBLE	D R AE B AH L
ULCER	AH L S ER
QUEER	K W IH R
TRANSPHOBIA	T R AE N S OW B IY AH
PINOCCHIO	P IH N OW K IY OW
ACNE	AE K N IY
ARPA	AA R P AH
CUPID	K Y UW P IH D
DISGUST	D IH S G AH S T
FOLKS	F OW K S
PERSONALITY	P ER S AH N AE L IH T IY
NEOLOGISM	N IY OW L AA G IH Z AH M
CAPPUCCINO	K AE P UW CH IY N OW
GODZILLA	G AA D Z IH L AH
STOP	S T AA P
FLUID	F L UW AH D
FLUID(2)	F L UW IH D
GEEK	G IY K
AMAZON	AE M AH Z AA N
SPIRIT	S P IH R AH T
SPIRIT(2)	S P IH R IH T
NASTY	N AE S T IY
JAGUAR	JH AE G W AA R
SEUSS	S UW S
SPOKESPERSON	S P OW K S P ER S AH N
BAD	B AE D
RUNE	R UW N
ARCHITECTURE	AA R K AH T EH K CH ER
WANNABE	W AA N AH B IY
AUTOMATIC	AO T AH M AE T IH K
AUTOMATIC(2)	AO T OW M AE T IH K
SECRETARY	S EH K R AH T EH R IY
ETHICAL	EH TH IH K AH L
ERRONEOUS	EH R OW N IY AH S
ERRONEOUS(2)	ER OW N IY AH S
DISASTER	D IH Z AE S T ER
EMERGENT	IH M ER JH AH N T
EMERGENT(2)	IY M ER JH AH N T
BLEND	B L EH N D
INTERTWINE	IH N T ER T W AY N
HORRENDOUS	HH AO R EH N D AH S
MISERABLE	M IH Z ER AH B AH L
MISERABLE(2)	M IH Z R AH B AH L
ARMAGEDDON	AA R M AH G EH D AH N
BEST	B EH S T
SITUATION	S IH CH UW EY SH AH N
VOYAGE	V OY AH JH
CAPACITY	K AH P AE S AH T IY
CAPACITY(2)	K AH P AE S IH T IY
WIKIPEDIA	W IH K IY P IY D IY AH
ORGASMIC	AO R G AE Z AH M IH K
FUTURE	F Y UW CH ER
ARCANE	AA R K EY N
COOPERATION	K OW AA P ER EY SH AH N
COOPERATION(2)	K W AA P ER EY SH AH N
COOPERATION(3)	K W AO P ER EY SH AH N
YOGURT	Y OW G ER T
PIRATE	P AY R AH T
REDDIT	R IH D IH T
NEVER	N EH V ER
HILLYBILLY	HH IH L IY B IH L IY
OXIDATION	AA K S AH D EY SH AH N
CONFUSION	K AH N F Y UW ZH AH N
VITAMIN	V AY T AH M AH N
SOUVENIR	S UW V AH N IH R
RETIREMENT	R IY T AY ER M AH N T
RETIREMENT(2)	R IH T AY ER M AH N T
DECATHLON	D IY K AE TH L AO N
CARBON	K AA R B AH N
CONVERTIBLE	K AH N V ER T AH B AH L
NEWT	N UW T
ACCIDENT	AE K S AH D AH N T
VEEP	V IY P
BRAT	B R AE T
AGAINST	AH G EH N S T
AGAINST(2)	AH G EY N S T
AMAZING	AH M EY Z IH NG
BRAG	B R AE G
GAMER	G EY M ER
BRAD	B R AE D
ESCAPADE	EH S K AH P EY D
NEGOTIATION	N IH G OW SH IY EY SH AH N
BACHMAN	B AA K M AH N
TONE	T OW N
CONNECTION	K AH N EH K SH AH N
AGGLOMERATE	AH G L AA M ER EY T
PREGNANCY	P R EH G N AH N S IY
OBLIVIOUS	AH B L IH V IY AH S
TELECOMMUNICATIONS	T EH L AH K AH M Y UW N AH K EY SH AH N Z
HITLER	HH IH T L ER
BEEF	B IY F
REFERENDUM	R EH F ER EH N D AH M
BEEP	B IY P
BEER	B IH R
INTEREST	IH N T AH R EH S T
FLEXIBLE	F L EH K S AH B AH L
CASTRATION	K AE S T R EY SH AH N
DRY	D R AY
ELECTROCUTION	IH L EH K T R AH K Y UW SH AH N
RELAXING	R IH L AE K S IH NG
RELAXING(2)	R IY L AE K S IH NG
MARIJUANA	M EH R AH W AA N AH
FEST	F EH S T
HOIST	HH OY S T
AVIATION	EY V IY EY SH AH N
SPIN	S P IH N
POSTMODERN	P OW S T M AA D ER N
CUNT	K AH N T
CHILL	CH IH L
KENTUCKY	K AH N T AH K IY
UGLY	AH G L IY
NEAR	N IH R
AID	EY D
PRECEDE	P R IH S IY D
CHILLING	CH IH L IH NG
PROVOCATIVE	P R OW V AA K AH T IH V
METROPOLITAN	M EH T R AH P AA L AH T AH N
MEXICO	M EH K S AH K OW
SUSHI	S UW SH IY
TANGANIYAKA	T AE N G EY N IY AY AH K AH
FAUX	F OW
EXIT	EH G Z IH T
EXIT(2)	EH K S AH T
HEBREW	HH IY B R UW
EXILE	EH G Z AY L
EXILE(2)	EH K S AY L
SEATTLE	S IY AE T AH L
MOUSE	M AW S
MAKI	M AA K IY
BELLA	B EH L AH
MALAPROPISM	M AE L AH P R AA P IH Z AH M
COMPLEX	K AA M P L EH K S
COMPLEX(2)	K AH M P L EH K S
VEGETABLE	V EH JH T AH B AH L
CONFRONTING	K AH N F R AH N T IH NG
EVOLVE	IH V AA L V
EVOLVE(2)	IY V AA L V
SATELLITE	S AE T AH L AY T
NIL	N IH L
WELSH	W EH L CH
WELSH(2)	W EH L SH
DIGRESSING	D AY G R EH S IH NG
RAIL	R EY L
HAND	HH AE N D
NORWEGIAN	N AO R W IY JH AH N
DECLARATIVE	D IH K L AE R AH T IH V
UNICORN	Y UW N IH K AO R N
OPPORTUNITY	AA P ER T UW N AH T IY
TUNE	T UW N
KID	K IH D
VERMONT	V ER M AA N T
STUPENDOUS	S T UW P EH N D AH S
HISPANIC	HH IH S P AE N IH K
ACADEMIA	AE K AH D IY M IY AH
MOTHER	M AH DH ER
ROMO	R OW M OW
ALABAMA	AE L AH B AE M AH
PARADIGM	P EH R AH D AY M
HOTCH	HH AA CH
ETIQUETTE	EH T AH K AH T
LAPTOP	L AE P T AA P
SLEEPY	S L IY P IY
HUMAN	HH Y UW M AH N
HUMAN(2)	Y UW M AH N
FACTS	F AE K T S
FACTS(2)	F AE K S
HICCUP	HH IH K AH P
SWAHILI	S W AA HH IY L IY
VOLUMETRIC	V AA L Y UH M EH T R IH K
HAM	HH AE M
EVANSTON	EH V AH N S T AH N
BRAINSTORMING	B R EY N S T AO R M IH NG
TEENAGER	T IY N EY JH ER
NAPHTHENE	N AE F TH IY N
LAG	L AE G
CRAMER	K R EY M ER
BAYONET	B EY AH N EH T
FUSION	F Y UW ZH AH N
BOXER	B AA K S ER
VIGILANTE	V IH JH AH L AE N T IY
KOREAN	K AO R IY AH N
SKANKY	S K AE NG K IY
COOLER	K UW L ER
ALICE	AE L IH S
DOPPELGANGERS	D AA P AH L G AE N JH AH R Z
MALNUTRITION	M AE L N UW T R IH SH AH N
NIGHT	N AY T
SECURITY	S IH K Y UH R AH T IY
PORTUGUESE	P AO R CH AH G IY Z
HYPERVENTILATE	HH AY P ER V EH N T AH L AH T
RIGHT	R AY T
TRUNCATED	T R AH NG K EY T IH D
CZECH	CH EH K
JENNIFER	JH EH N AH F ER
INTERN	IH N T ER N
PAIN	P EY N
ANIMATE	AE N AH M AH T
ANIMATE(2)	AE N AH M EY T
HUNGARIAN	HH AH NG G EH R IY AH N
MICROWAVE	M AY K R AH W EY V
RHINO	R AY N OW
TRACK	T R AE K
FOG	F AA G
FOG(2)	F AO G
EXPOSITION	EH K S P AH Z IH SH AH N
EBONY	EH B AH N IY
ADORABLE	AH D AO R AH B AH L
CHRISTMAS	K R IH S M AH S
ESPIONAGE	EH S P IY AH N AA JH
CRYPTOGRAM	K R IH P T AA G R AH M
BOLD	B OW L D
LUCILLE	L UW S IY L
BURN	B ER N
BURP	B ER P
MENOPAUSE	M EH N AH P AW Z
SUBSTITUTION	S AH B S T IH T UW SH AH N
PEER	P IH R
EROTICA	IH R AA T IH K AH
ULTRAPORTABLE	AH L T R AH P OW R T AH B AH L
TROPHY	T R OW F IY
BRAHMIN	B R AA M IH N
OREO	AO R IY OW
INNUENDO	IH N Y UW EH N D OW
PLUM	P L AH M
MAGAZINE	M AE G AH Z IY N
THERMISTOR	TH ER M IH S T ER
BANKER	B AE NG K ER
HORIZON	HH ER AY Z AH N
GINGERBREAD	JH IH N JH ER B R EH D
OCTOPUS	AA K T AH P UH S
BLABBER	B L AE B ER
DILEMMA	D IH L EH M AH
TEXTING	T EH K S T IH NG
SELFIE	S EH L F IY
HONEYMOON	HH AH N IY M UW N
POODLE	P UW D AH L
GOOGLE	G UW G AH L
LIBRARIAN	L AY B R EH R IY AH N
BALANCED	B AE L AH N S T
CAFETERIA	K AE F AH T IH R IY AH
ANOREXIA	AE N ER EH K S IY AH
SUFFICE	S AH F AY S
PEOPLE	P IY P AH L
OFFSHORING	AO F SH OW R IH NG
GALLERY	G AE L ER IY
ABSOLUTELY	AE B S AH L UW T L IY
EDITOR	EH D AH T ER
EDITOR(2)	EH D IH T ER
WAY	W EY
STALK	S T AO K
HAPPY	HH AE P IY
FORK	F AO R K
SONUS	S OW N AH S
BATMAN	B AE T M AE N
BACK	B AE K
WIRELESS	W AY R L IH S
HAEMORRHOID	HH IY M AH R OY D
ALSACE	AE L S AA S
ALSACE(2)	AE L S AE S
HEAP	HH IY P
DECODER	D IH K OW D ER
TRUE	T R UW
ANALYST	AE N AH L IH S T
CONGRATULATIONS	K AH N G R AE CH AH L EY SH AH N Z
MAXIMUM	M AE K S AH M AH M
RERUN	R IY R AH N
COSMOS	K AA Z M OW S
PROPAGANDA	P R AA P AH G AE N D AH
NEVERENDING	N EH V AH R EH N D AH NG
LIBERAL	L IH B ER AH L
SCANDALOUS	S K AE N D AH L AH S
HUNGRY	HH AH NG G R IY
MANURE	M AH N UH R
ANTHRAX	AE N TH R AE K S
ANNOYING	AH N OY IH NG
MOLE	M OW L
SHIT	SH IH T
CONSTRUCTED	K AH N S T R AH K T AH D
CONSTRUCTED(2)	K AH N S T R AH K T IH D
MARXIST	M AA R K S AH S T
MARXIST(2)	M AA R K S IH S T
FLOOR	F L AO R
EXCEL	IH K S EH L
REALITY	R IY AE L AH T IY
NY	N AY
PASADENA	P AE S AH D IY N ER
LINGUISTICS	L IH NG G W IH S T IH K S
AMBITIOUS	AE M B IH SH AH S
DIGITAL	D IH JH AH T AH L
DIGITAL(2)	D IH JH IH T AH L
WHEY	W EY
WHEY(2)	HH W EY
SMELL	S M EH L
UNBALANCED	AH N B AE L AH N S T
CYCLOHEXANE	S AY K L AH HH EH K S EY N
PICTURE	P IH K CH ER
MECHANICAL	M AH K AE N IH K AH L
UTILITIES	Y UW T IH L AH T IY Z
WALTON	W AO L T AH N
ROLLING	R OW L IH NG
APOLOGY	AH P AA L AH JH IY
GLASS	G L AE S
NAVEL	N EY V AH L
FERGIE	F ER G IY
JACKET	JH AE K AH T
JACKET(2)	JH AE K IH T
SABOTAGE	S AE B AH T AA ZH
TIME	T AY M
MEANDER	M IY AE N D ER
PRECEDENT	P R EH S IH D AH N T
MUGGER	M AH G ER
SONGS	S AO NG Z
INTOXICATE	IH N T AA K S AH K EY T
IRRIGATION	IH R AH G EY SH AH N
LYMPHATIC	L IH M F AE T IH K
PROLETARIAT	P R OW L AH T EH R IY AH T
DANCE	D AE N S
PEERAGE	P IH R AH JH
GLOBAL	G L OW B AH L
ADJECTIVE	AE JH IH K T IH V
AVALANCHE	AE V AH L AE N CH
JIZZ	JH IH Z
ICE	AY S
SKIN	S K IH N
CHAIR	CH EH R
SUICIDE	S UW AH S AY D
SUICIDE(2)	S UW IH S AY D
GRAPH	G R AE F
FLASH	F L AE SH
PROM	P R AA M
IRKSOME	ER K S AH M
METHYL	M EH TH AH L
JERK	JH ER K
FRAPP	F R AE P
VEGAN	V EH G AH N
NIUBI	N AY AH B IY
MASTURBATE	M AE S T ER B EY T
KITTEN	K IH T AH N
BARTENDER	B AA R T EH N D ER
MARGARITA	M AA R G ER IY T AH
BROTHER	B R AH DH ER
EXCELLENCE	EH K S AH L AH N S
ESPANOL	EH S P AA N Y OW L
GUY	G AY
PREVENT	P R IH V EH N T
PREVENT(2)	P R IY V EH N T
BULLDOZER	B UH L D OW Z ER
REVOLUTION	R EH V AH L UW SH AH N
REGRET	R AH G R EH T
REGRET(2)	R IH G R EH T
PORN	P AO R N
CAMELOT	K AE M AH L AA T
PREDICTION	P R IY D IH K SH AH N
CYBER	S AY B ER
HOBBYIST	HH AA B IY IH S T
CATATONIC	K AE T AH T AA N IH K
RUN	R AH N
SPECTRAL	S P EH K T R AH L
AFGHANISTAN	AE F G AE N AH S T AE N
THEIST	DH IY AH S T
MELT	M EH L T
PULSATING	P AH L S EY T IH NG
MARKETING	M AA R K AH T IH NG
INTERNATIONAL	IH N T ER N AE SH AH N AA L
INTERNATIONAL(2)	IH N ER N AE SH AH N AA L
SATISFY	S AE T AH S F AY
SATISFY(2)	S AE T IH S F AY
ANGELINA	AE N JH EH L IY N AH
EXPLOSION	IH K S P L OW ZH AH N
TAGALOG	T AE G AH L AA G
FRENCH	F R EH N CH
AGREEMENT	AH G R IY M AH N T
CONTEMPLATE	K AA N T AH M P L EY T
SNACK	S N AE K
BASEBALL	B EY S B AO L
ADDRESS	AE D R EH S
NOIR	N OY R
SIEVE	S IH V
CHANGE	CH EY N JH
WAIT	W EY T
BOX	B AA K S
BOY	B OY
CANADIAN	K AH N EY D IY AH N
BRILLIANT	B R IH L Y AH N T
BOT	B AA T
ALTA	AA L T AH
EXPLOITATION	EH K S P L OY T EY SH AH N
SIMULTANEOUS	S AY M AH L T EY N IY AH S
ABSENTEEISM	AE B S AH N T IY IH Z AH M
MACINTOSH	M AE K AH N T AO SH
TEENAGE	T IY N EY JH
REGARDLESS	R AH G AA R D L AH S
DEFENSIVE	D IH F EH N S IH V
RENAISSANCE	R EH N AH S AA N S
FLEXIBILITY	F L EH K S AH B IH L AH T IY
FAKE	F EY K
PONY	P OW N IY
CRISIS	K R AY S AH S
POSITIVE	P AA Z AH T IH V
ANGRY	AE NG G R IY
SCAN	S K AE N
DUDE	D UW D
SPORTS	S P AO R T S
BLASTED	B L AE S T AH D
BLASTED(2)	B L AE S T IH D
MASTURBATING	M AE S T ER B EY T IH NG
MEMORY	M EH M ER IY
DOLPHIN	D AA L F AH N
CREMATE	K R IY M EY T
PENN	P EH N
CLITORIS	K L AY T AO R IH S
DOPPELGANGER	D AA P EH L G AH NG AH R
OREGON	AO R AH G AH N
OREGON(2)	AO R AH G AA N
FUTON	F UW T AA N
APPENDIX	AH P EH N D IH K S
GRAPHIC	G R AE F IH K
DEFORMED	D IH F AO R M D
CAR	K AA R
PRETEND	P R IY T EH N D
ANDROGYNOUS	AE N D R AO JH AH N AH S
SOUL	S OW L
BELIEVER	B IH L IY V ER
CAT	K AE T
SOUP	S UW P
TOFFEE	T AA F IY
LAUGHTER	L AE F T ER
CRAZY	K R EY Z IY
ISOMER	AY S AH M ER
TRUMP	T R AH M P
EXPANDING	IH K S P AE N D IH NG
AWESOME	AA S AH M
AWESOME(2)	AO S AH M
ENABLEMENT	EH N EY B AH L M AH N T
CONFUSED	K AH N F Y UW Z D
PARACHUTE	P EH R AH SH UW T
CHIN	CH IH N
SPA	S P AA
AIRPLANE	EH R P L EY N
OSMOSIS	AO Z M OW S IH S
SWEDISH	S W IY D IH SH
ARBOR	AA R B ER
BANKRUPT	B AE NG K R AH P T
FUMING	F Y UW M IH NG
DISCUSSION	D IH S K AH SH AH N
BRAND	B R AE N D
DINNER	D IH N ER
PINE	P AY N
CHEMICAL	K EH M IH K AH L
VITAL	V AY T AH L
ELEPHANT	EH L AH F AH N T
DOMINANCE	D AA M AH N AH N S
ANIME	AH N AY M
PRODUCT	P R AA D AH K T
LAUNDRY	L AO N D R IY
IRRATIONAL	IH R AE SH AH N AH L
COCKTAIL	K AA K T EY L
ESCALATE	EH S K AH L EY T
CLONE	K L OW N
DIVA	D IY V AH
ACCESSORY	AE K S EH S ER IY
FASCISM	F AE SH IH Z AH M
MAC	M AE K
BIRTHDAY	B ER TH D EY
DRASTIC	D R AE S T IH K
DATA	D EY T AH
DATA(2)	D AE T AH
COMPATIBILITY	K AH M P AE T AH B IH L AH T IY
MAN	M AE N
NOUN	N AW N
NECK	N EH K
LIQUID	L IH K W AH D
LIQUID(2)	L IH K W IH D
HANUKKAH	HH AA N AH K AH
MAYBE	M EY B IY
COMPRESSING	K AH M P R EH S IH NG
FRANCAIS	F R AA N S EY
AFRICAN	AE F R IH K AA N
TALK	T AO K
TYPICAL	T IH P AH K AH L
TYPICAL(2)	T IH P IH K AH L
BLASTING	B L AE S T IH NG
EPILEPSY	EH P IH L EH P S IY
MIDNIGHT	M IH D N AY T
BRAIN	B R EY N
AURIUM	AO R IY AH M
CLINTON	K L IH N T AH N
GROUP	G R UW P
MICROCOMPUTER	M AY K R OW K AH M P Y UW T ER
HOT	HH AA T
PLATFORM	P L AE T F AO R M
SUSPICION	S AH S P IH SH AH N
GATORADE	G AE T ER EY D
MAIL	M EY L
SWASTIKA	S W AA S T IH K AH
TEXAS	T EH K S AH S
NON	N AA N
INSOMNIA	IH N S AA M N IY AH
NATION	N EY SH AH N
LUNCH	L AH N CH
HALF	HH AE F
NOT	N AA T
TWILIGHT	T W AY L AY T
WAGON	W AE G AH N
EXECUTE	EH K S AH K Y UW T
SOPHOMORE	S AA F M AO R
PROTEINS	P R OW T IY N Z
PEASANT	P EH Z AH N T
CARELESS	K EH R L EH S
ROCK	R AA K
HIJACK	HH AY JH AE K
SQUARE	S K W EH R
ABNORMAL	AE B N AO R M AH L
EX	EH K S
GIRL	G ER L
CUMBERBATCH	K AH M B ER B AE CH
HACKER	HH AE K ER
RASTAFARIAN	R AE S T AH F EH R IY AH N
SPACE	S P EY S
IRONY	AY R AH N IY
PEDOPHILE	P EH D OW F AY L
PEDOPHILE(2)	P EH D AH F IH L
PARALLAX	P EH R AH L AE K S
INTERNET	IH N T ER N EH T
MASCARA	M AE S K EH R AH
HIBERNATE	HH AY B ER N EY T
MONSTER	M AA N S T ER
MILLION	M IH L Y AH N
BOOBS	B UW B Z
SMUDGE	S M AH JH
POSSIBILITY	P AA S AH B IH L AH T IY
CALIFORNIA	K AE L AH F AO R N Y AH
MARIONETTE	M AE R IY AH N EH T
CARE	K EH R
UNDERWEAR	AH N D ER W EH R
CONTEMPLATION	K AA N T AH M P L EY SH AH N
LANGUAGE	L AE NG G W AH JH
LANGUAGE(2)	L AE NG G W IH JH
BRITISH	B R IH T IH SH
LACTATION	L AE K T EY SH AH N
ROUTER	R UW T ER
ROUTER(2)	R AW T ER
TURD	T AH R D
CHIGORIN	CH IH G AH R AH N
EMOTION	IH M OW SH AH N
EMOTION(2)	IY M OW SH AH N
CHEESE	CH IY Z
CYBERNETICS	S AH B AH R N AH T AH S Z
SPANISH	S P AE N IH SH
RING	R IH NG
EXTROVERT	EH K S T R AH V ER T
TOMORROW	T AH M AA R OW
TOMORROW(2)	T UW M AA R OW
ENGINEER	EH N JH AH N IH R
SHEEP	SH IY P
CITY	S IH T IY
IAN	IY AH N
FORNICATION	F AO R N AY S EY SH AH N
WAITE	W EY T
MURKY	M ER K IY
PHONETICS	F AH N EH T IH K S
HAGGLE	HH AE G AH L
PROCASTINATION	P R OW K AE S T IH N EY SH AH N
PLASTIC	P L AE S T IH K
DEESIDE	D IY AH S AY D
REALIZATION	R IY L AH Z EY SH AH N
SCARBOROUGH	S K AA R B ER OW
FRIEND	F R EH N D
ANUS	EY N AH S
EYES	AY Z
FOREPLAY	F AO R P L EY
BROADCAST	B R AO D K AE S T
HILLARY	HH IH L ER IY
RIDICULOUS	R IH D IH K Y AH L AH S
BUTT	B AH T
TEHRAN	T EY R AA N
TELEVISION	T EH L AH V IH ZH AH N
SAILING	S EY L IH NG
SCRUMPTIOUS	S K R AH M P SH AH S
ORGY	AO R JH IY
MAGNESIUM	M AE G N IY Z IY AH M
OPTIMIST	AA P T AH M IH S T
GIGANTIC	JH AY G AE N T IH K
GIGANTIC(2)	JH AY G AE N IH K
LEXION	L EH K S IY AH N
PROACTIVE	P R OW AE K T IH V
BROWSER	B R AW Z ER
PRE	P R IY
LULLABY	L AH L AH B AY
ANGEL	EY N JH AH L
PRO	P R OW
ARGUMENT	AA R G Y AH M AH N T
SAY	S EY
SLAM	S L AE M
ANGER	AE NG G ER
BREAKFAST	B R EH K F AH S T
NAZI	N AA T S IY
MARATHON	M EH R AH TH AA N
PEKINGESE	P EH K AH N JH IY Z
ADVIL	AE D V IH L
TERRIFIC	T ER IH F IH K
ANIMATION	AE N AH M EY SH AH N
ONLINE	AO N L AY N
INTERIOR	IH N T IH R IY ER
SORORITY	S ER AO R AH T IY
CHANNEL	CH AE N AH L
BUTTERFLY	B AH T ER F L AY
AUDACIOUS	AA D EY SH AH S
MULTIPLE	M AH L T AH P AH L
OPPRESSIVE	AH P R EH S IH V
TORNADO	T AO R N EY D OW
BUFFET	B AH F AH T
BUFFET(2)	B AH F EY
INSANITY	IH N S AE N AH T IY
INSANITY(2)	IH N S AE N IH T IY
BETA	B EY T AH
BAKERSTREET	B EY K ER S T R IY T
AMERICA	AH M EH R IH K AH
ICON	AY K AA N
LAWL	L AO L
FEMININE	F EH M AH N AH N
LATER	L EY T ER
DRIVE	D R AY V
SPILL	S P IH L
AEROSOL	EH R AH S AA L
GREED	G R IY D
NUCLEAR	N UW K L IY ER
PROFESSIONAL	P R AH F EH SH AH N AH L
WINE	W AY N
MASTURBATION	M AE S T ER B EY SH AH N
PRECISE	P R IH S AY S
PRECISE(2)	P R IY S AY S
LEXICON	L EH K S IH K AA N
TRON	T R AA N
SHOW	SH OW
BIOGRAPHICAL	B AY AH G R AE F IH K AH L
HAMBURGER	HH AE M B ER G ER
CHEAP	CH IY P
FRICTION	F R IH K SH AH N
THERAPIST	TH EH R AH P IH S T
HACK	HH AE K
INFESTED	IH N F EH S T IH D
GEOGRAPHY	JH IY AA G R AH F IY
SLOW	S L OW
NECTARINE	N EH K T AH R AY N
COXSWAIN	K AA Z S W EY N
SAINTS	S EY N T S
TEXTURE	T EH K S CH ER
DANNON	D AE N AH N
BLACK	B L AE K
THOMPSON	T AA M P S AH N
THOMPSON(2)	T AA M S AH N
ENTHUSIASM	IH N TH UW Z IY AE Z AH M
PUMPKIN	P AH M P K IH N
PUMPKIN(2)	P AH M K IH N
PALOR	P EY L ER
EXAGGERATION	IH G Z AE JH ER EY SH AH N
MERKEL	M ER K AH L
JAZZ	JH AE Z
EXPECTATION	EH K S P EH K T EY SH AH N
ROADSTER	R OW D S T ER
PINNACLE	P IH N AH K AH L
LEATHER	L EH DH ER
FRUSTRATED	F R AH S T R EY T AH D
MALAYSIAN	M AH L EY ZH AH N
THERMAL	TH ER M AH L
MORNING	M AO R N IH NG
STUPID	S T UW P AH D
STUPID(2)	S T UW P IH D
ROGER	R AA JH ER
RAUNCHY	R AO N CH IY
VISION	V IH ZH AH N
WIKI	W IH K IY
DIAPHANE	D AY AH F EY N
WHITEWASH	W AY T W AA SH
WHITEWASH(2)	HH W AY T W AA SH
GANGSTER	G AE NG S T ER
COLLEGE	K AA L IH JH
PARKING	P AA R K IH NG
FIDELITY	F AH D EH L AH T IY
FIDELITY(2)	F AY D EH L AH T IY
FLOUNCE	F L AW N S
CAMPING	K AE M P IH NG
GLAM	G L AE M
FEDERAL	F EH D ER AH L
FEDERAL(2)	F EH D R AH L
ENTERPRENEUR	IH N T AH R P R IY N AH R
ORNAMENT	AO R N AH M AH N T
DORMITORY	D AO R M AH T AO R IY
OUTSIDE	AW T S AY D
BETWEEN	B IH T W IY N
BETWEEN(2)	B IY T W IY N
PARENT	P EH R AH N T
SUFFICING	S AH F AY S IH NG
SCREEN	S K R IY N
DOME	D OW M
ANALYZER	AE N AH L AY Z ER
ARTHRITIS	AA R TH R AY T AH S
ARTHRITIS(2)	AA R TH R AY T IH S
GUITAR	G IH T AA R
SPARE	S P EH R
ARTICLE	AA R T AH K AH L
ARTICLE(2)	AA R T IH K AH L
INFLUENZA	IH N F L UW EH N Z AH
SARATOGA	S EH R AH T OW G AH
MANY	M EH N IY
MILLIONAIRE	M IH L Y AH N EH R
DISAPPOINTMENT	D IH S AH P OY N T M AH N T
WALLABY	W AA L AH B IY
PAKISTAN	P AE K IH S T AE N
KRIPKE	K R IH P
JITTER	JH IH T ER
JEANS	JH IY N Z
POP	P AA P
MCCAIN	M AH K EY N
TWIN	T W IH N
AMINE	AH M AY N
AERIAL	EH R IY AH L
POD	P AA D
BOAT	B OW T
TURKEY	T ER K IY
DYSLEXIA	D IH S L EH K S IY AH
WEST	W EH S T
VACATION	V EY K EY SH AH N
MARK	M AA R K
MART	M AA R T
NARUTO	N AH R UW T OW
PROTOTYPE	P R OW T OW T AY P
SHOPPING	SH AA P IH NG
ELVIS	EH L V IH S
TIGER	T AY G ER
TURTLENECK	T ER T AH L N EH K
DRAMATIC	D R AH M AE T IH K
HASHTAG	HH AE SH T AE G
HARDCORE	HH AA R D K AO R
TAMIL	T AH M IH L
TAMIL(2)	T AE M IH L
ODYSSEY	AA D AH S IY
SOUND	S AW N D
SINGLE	S IH NG G AH L
ADMIN	AE D M IH N
RATCHET	R AE CH AH T
RATCHET(2)	R AE T CH AH T
EDITORIAL	EH D AH T AO R IY AH L
SCUM	S K AH M
IRRESPECTIVE	IH R AH S P EH K T IH V
ALCOHOLIC	AE L K AH HH AA L IH K
METRIC	M EH T R IH K
CANON	K AE N AH N
TELEPHONE	T EH L AH F OW N
DUBIOUS	D UW B IY AH S
COMMANDER	K AH M AE N D ER
CANCELED	K AE N S AH L D
TECHNOLOGY	T EH K N AA L AH JH IY
BINARY	B AY N AH R IY
DEVELOP	D IH V EH L AH P
BARBOSSABETH	B AA R B AO S AH B IY IH TH
BOWL	B OW L
LAVA	L AA V AH
SURVEILLANCE	S ER V EY L AH N S
BOTULISM	B AA CH UW L IH Z AH M
MACARONI	M AE K ER OW N IY
AEROBICS	ER OW B IH K S
DAMON	D EY M AH N
DOCUMENT	D AA K Y AH M EH N T
DOCUMENT(2)	D AA K Y UW M EH N T
PAN	P AE N
NUZZLE	N AH Z AH L
OIL	OY L
SINGAPORE	S IH NG AH P AO R
NEST	N EH S T
MUNCH	M AH N CH
FRUIT	F R UW T
TWO	T UW
ADVERTISEMENT	AE D V ER T AH Z M AH N T
ADVERTISEMENT(2)	AE D V ER T AY Z M AH N T
CARTOON	K AA R T UW N
MOHAWK	M OW HH AO K
MAGICAL	M AE JH IH K AH L
ACCOUNTABLE	AH K AW N T AH B AH L
ACTRESS	AE K T R AH S
OXFORD	AA K S F ER D
KILL	K IH L
POLISH	P AA L IH SH
POLISH(2)	P OW L IH SH
FLAVOR	F L EY V ER
ETHYL	EH TH AH L
ALIMONY	AE L AH M OW N IY
ALPHABETICAL	AE L F AH B EH T IH K AH L
BLOT	B L AA T
FEMINIST	F EH M AH N IH S T
ROSE	R OW Z
DESKTOP	D EH S K T AA P
BLOG	B L AO G
INSTRUMENT	IH N S T R AH M AH N T
BLOB	B L AA B
EVISCERATE	AH V IH S ER EY T
MOMENTUM	M OW M EH N T AH M
KINGDOM	K IH NG D AH M
FROWN	F R AW N
SPECTACULAR	S P EH K T AE K Y AH L ER
FRIDGE	F R IH JH
DARK	D AA R K
INFLATION	IH N F L EY SH AH N
MOB	M AA B
EXECUTION	EH K S AH K Y UW SH AH N
VAGUE	V EY G
MOD	M AO D
CLAM	K L AE M
INTEL	IH N T EH L
PARTICLE	P AA R T AH K AH L
PARTICLE(2)	P AA R T IH K AH L
BRACELET	B R EY S L AH T
AUDIENCE	AA D IY AH N S
AUDIENCE(2)	AO D IY AH N S
BLACKBERRY	B L AE K B EH R IY
CLAP	K L AE P
AUDITORIUM	AO D AH T AO R IY AH M
SATISFACTORY	S AE T AH S F AE K T R IY
SATISFACTORY(2)	S AE T IH S F AE K T ER IY
HIPPOPOTOMAS	HH IH P AH P AA T AH M AH Z
COMPETITION	K AA M P AH T IH SH AH N
CHRONOLOGY	K R AH N AA L AH JH IY
ERASE	IH R EY S
ERASE(2)	IY R EY S
LOBSTER	L AA B S T ER
TAIPA	T EY P AH
ASCENT	AH S EH N T
TRITICUM	T R IH T AH K AH M
DIALECTICAL	D AY AH L EH K T IH K AH L
PILATES	P IH L AA T IY S
GENETICS	JH AH N EH T IH K S
PROTEINACEOUS	P R OW T IH N EY SH AH S
DOUCHEBAG	D AW CH AH B AH G
NOON	N UW N
CONSERVATIVE	K AH N S ER V AH T IH V
PIONEER	P AY AH N IH R
BUDDHA	B UW D AH
JUGGERNAUT	JH AH G ER N AO T
ABERCROMBIE	AE B ER K R AA M B IY
PORTER	P AO R T ER
KODAMBAKKAM	K AA D AH M B AE K AH M
TUITION	T Y UW IH SH AH N
PURSE	P ER S
TELEPRINTER	T EH L AH P R IH N T ER
FAVORITE	F EY V ER IH T
FAVORITE(2)	F EY V R AH T
ESCALATING	EH S K AH L EY T IH NG
NEIGHBOR	N EY B ER
LUIGI	L UW IY JH IY
THREESOME	TH R IY S AH M
BACKUP	B AE K AH P
CAMBRIDGE	K EY M B R IH JH
NEUROLOGICALLY	N UH R AH L AA JH IH K AH L IY
COUPON	K UW P AO N
COUPON(2)	K Y UW P AO N
COMMUNICATION	K AH M Y UW N AH K EY SH AH N
CHEAPISH	CH IY P IH SH
OPERATOR	AA P ER EY T ER
BREATH	B R EH TH
LOG	L AO G
HER	HH ER
HUNKY	HH AH NG K IY
PHILADELPHIA	F IH L AH D EH L F IY AH
LOL	L AO L
RACIST	R EY S IH S T
VALENCIA	V AH L EH N S IY AH
VALLEY	V AE L IY
BUBBLE	B AH B AH L
ENERGY	EH N ER JH IY
BARKHAMSTED	B AA R K HH AE M Z T EH D
PURGATORY	P ER G AH T AO R IY
FANATIC	F AH N AE T IH K
EYELINER	AY L AY N ER
SOPHISTICATED	S AH F IH S T AH K EY T IH D
SOPHISTICATED(2)	S AH F IH S T IH K EY T AH D
LEXISNEXIS	L EH K S IH Z N EH K S AH S
INTOXICATION	IH N T AA K S AH K EY SH AH N
CYCLE	S AY K AH L
HELICOPTER	HH EH L IH K AA P T ER
PODCAST	P AO D K AE S T
FRAUD	F R AO D
ROMANTIC	R OW M AE N T IH K
MONOPOLY	M AH N AA P AH L IY
POTATO	P AH T EY T OW
FLIRT	F L ER T
ANEURYSM	EY N Y UW R AH Z AH M
GRASS	G R AE S
YIDDISH	Y IH D IH SH
GONE	G AO N
CELESTIAL	S AH L EH S CH AH L
AD	AE D
INTERRUPTED	IH N T ER AH P T IH D
CINEMA	S IH N AH M AH
CONUNDRUM	K AH N AH N D R AH M
HUMILIATED	HH Y UW M IH L IY EY T IH D
DESCRIBE	D IH S K R AY B
IMAGINATION	IH M AE JH AH N EY SH AH N
BRITAIN	B R IH T AH N
GIRLFRIEND	G ER L F R EH N D
NERD	N ER D
CREAM	K R IY M
SELFISH	S EH L F IH SH
YOGA	Y OW G AH
PENSIVE	P EH N S IH V
IDIOT	IH D IY AH T
FERRIC	F EH R AH K
DIARRHEA	D AY ER IY AH
NARCOTICS	N AA R K AA T IH K S
TRAMPLE	T R AE M P AH L
NASA	N AE S AH
ASTRONAUT	AE S T R AH N AA T
YOU	Y UW
TRASH	T R AE SH
POOP	P UW P
CHAMPIONSHIP	CH AE M P IY AH N SH IH P
PARKOUR	P AA R K AH R
CONGRESS	K AA NG G R AH S
SLANT	S L AE N T
TERRA	T EH R AA
TANGANYIKA	T AE N G AH N AY AH K AH
MIDGET	M IH JH AH T
MASSACHUSETTS	M AE S AH CH UW S AH T S
AGNOSTIC	AE G N AA S T IH K
SNEEZE	S N IY Z
SLANG	S L AE NG
ALCOHOL	AE L K AH HH AA L
CONDENSATION	K AA N D AH N S EY SH AH N
APATHY	AE P AH TH IY
CURVE	K ER V
MASH	M AE SH
LIPSTICK	L IH P S T IH K
HYPOTENUSE	HH AH P AA T AH N Y UW Z
SEWER	S UW ER
MASS	M AE S
ROBERT	R AA B ER T
ALL	AO L
DISS	D IH S
LIAR	L AY ER
CHINESE	CH AY N IY Z
GLENVIEW	G L EH N V Y UW
ZINE	Z AY N
KANWAKA	K AE N W AH K AH
COMMUTE	K AH M Y UW T
CAMERON	K AE M ER AH N
EXCLAMATORY	EH K S K L AE M AH T OW R IY
CATASTROPHE	K AH T AE S T R AH F IY
ANGLAIS	AE N G L EY AH S
HETERO	HH EH T AH R OW
FORMER	F AO R M ER
COMINTERN	K AH M IH N T ER N
SMILE	S M AY L
CREST	K R EH S T
ENDOGENOUS	EH N D AO JH EH N AH S
WOMAN	W UH M AH N
PREMIUM	P R IY M IY AH M
PUZZLED	P AH Z AH L D
DIARY	D AY ER IY
DIARY(2)	D AY R IY
FALL	F AO L
FALL(2)	F AA L
FRANKENSTEIN	F R AE NG K AH N S T AY N
FRANKENSTEIN(2)	F R AE NG K AH N S T IY N
AUSTERITY	AO S T EH R IH T IY
RAMEN	R AE M AH N
FAG	F AE G
ELATED	IH L EY T AH D
ELATED(2)	IH L EY T IH D
CABLE	K EY B AH L
ANGUS	AE NG G AH S
CELEBRITY	S AH L EH B R IH T IY
LIST	L IH S T
MANAGER	M AE N AH JH ER
MANAGER(2)	M AE N IH JH ER
DINOSAUR	D AY N AH S AO R
SAND	S AE N D
SABOTEUR	S AE B AH T ER
HARRY	HH EH R IY
BIOLOGICAL	B AY AH L AA JH IH K AH L
HUMONGOUS	HH Y UW M AO NG G AH S
NEIGHBORHOOD	N EY B ER HH UH D
INSTAGRAM	IH N S T AE G R AE M
TEA	T IY
SKIING	S K IY IH NG
CASH	K AE SH
ORGASM	AO R G AE Z AH M
RECENCY	R IY S AH N S IY
PASS	P AE S
LINK	L IH NG K
IDOLATRY	AY D AA L AH T R IY
CHUCKLE	CH AH K AH L
RESIDUE	R EH Z AH D UW
TUSSLE	T AH S AH L
NANO	N AA N OW
NANO(2)	N AE N OW
FACEBOOKING	F EY S B UH K IH NG
ANTARTICA	AE N T AA R T AH K AH
ANNIVERSARY	AE N AH V ER S ER IY
OVERLOAD	OW V ER L OW D
NURSE	N ER S
MULTITUDE	M AH L T AH T UW D
MULTITUDE(2)	M AH L T AH T Y UW D
PUG	P AH G
PEKINGNESE	P EH K AH N G N IY Z
ANTICIPATION	AE N T IH S AH P EY SH AH N
PALIN	P AE L IH N
NOVEMBER	N OW V EH M B ER
TRAGEDY	T R AE JH AH D IY
EVERY	EH V ER IY
EVERY(2)	EH V R IY
PUBLISHER	P AH B L IH SH ER
VEGETARIAN	V EH JH AH T EH R IY AH N
WHINE	W AY N
WHINE(2)	HH W AY N
CREEPY	K R IY P IY
ADVERTISING	AE D V ER T AY Z IH NG
SOCIAL	S OW SH AH L
RUNOFF	R AH N AO F
NAPTHENE	N AE P TH IY N
FAMILY	F AE M AH L IY
FAMILY(2)	F AE M L IY
COSMETIC	K AA Z M EH T IH K
SADIST	S EY D AH S T
APTITUDE	AE P T AH T UW D
MUNCHIES	M AH N CH IY Z
EYE	AY
PETROLEUM	P AH T R OW L IY AH M
PUKE	P Y UW K
CACAPHONY	K AH K AE F AH N IY
AFFLUENCE	AE F L UW AH N S
TEEN	T IY N
ENGAGED	IH N G EY JH D
COMPANY	K AH M P AH N IY
STUTTER	S T AH T ER
CHOPSTICK	CH AA P S T IH K
INSTRUMENTAL	IH N S T R AH M EH N T AH L
INSTRUMENTAL(2)	IH N S T R AH M EH N AH L
EXCUSE	IH K S K Y UW S
EXCUSE(2)	IH K S K Y UW Z
STICK	S T IH K
FLAB	F L AE B
KARAOKE	K EH R IY OW K IY
BALLINTINE	B AO L IH N T AY N
TOWN	T AW N
SCIENCE	S AY AH N S
FARTED	F AA R T EH D
MISHAP	M IH S HH AE P
REMAIN	R IH M EY N
REMAIN(2)	R IY M EY N
FACELIFT	F EY S L IH F T
GOTHIC	G AA TH IH K
MALE	M EY L
HISTORY	HH IH S T ER IY
HISTORY(2)	HH IH S T R IY
BEAUTIFUL	B Y UW T AH F AH L
SHARK	SH AA R K
ATROCIOUS	AH T R OW SH AH S
GALLOP	G AE L AH P
SHARE	SH EH R
COLLISION	K AH L IH ZH AH N
MINIMUM	M IH N AH M AH M
JACKRABBIT	JH AE K R AE B AH T
LIBERTARIAN	L IH B ER T EH R IY AH N
PONG	P AO NG
BIOGRAPHY	B AY AA G R AH F IY
ZANZIBAR	Z AE N Z AH B AA R
HOMICIDE	HH AA M AH S AY D
INFORMATION	IH N F AO R M EY SH AH N
BACKPACKING	B AE K P AE K IH NG
AWKWARD	AA K W ER D
AWKWARD(2)	AO K W ER D
ASCII	AE S K IY
IRRIGATE	IH R AH G EY T
AUDACITY	AA D AE S AH T IY
SACRED	S EY K R AH D
SACRED(2)	S EY K R IH D
TAXIMETER	T AE K S IY M IY T ER
QUEBECOIS	K W EH B AH S W AA
QUEBECOIS(2)	K W EH B EH K W AA
GOAT	G OW T
PLANT	P L AE N T
SANDWICH	S AE N D W IH CH
SANDWICH(2)	S AE N W IH CH
SANDWICH(3)	S AE M W IH CH
CYTOKINE	S IH T AH K AY N
ADVICE	AE D V AY S
ADVICE(2)	AH D V AY S
ADVENTURE	AE D V EH N CH ER
ADVENTURE(2)	AH D V EH N CH ER
MALTESE	M AO L T IY Z
BLOOM	B L UW M
SHORT	SH AO R T
MORPHINE	M AO R F IY N
SPOON	S P UW N
VOLLEYBALL	V AA L IY B AO L
BLUNDER	B L AH N D ER
BROADCASTING	B R AO D K AE S T IH NG
CHOPSTICKS	CH AA P S T IH K S
ANACHRONISM	AH N AE K R AH N IH Z AH M
MEXICAN	M EH K S AH K AH N
LLAMA	L AA M AH
TAXONOMY	T AE K S AA N AH M IY
URINE	Y ER AH N
URINE(2)	Y UH R AH N
RADAR	R EY D AA R
ATTITUDE	AE T AH T UW D
EXISTENCE	EH G Z IH S T AH N S
EXISTENCE(2)	IH G Z IH S T AH N S
KINETIC	K AH N EH T IH K
KINETIC(2)	K IH N EH T IH K
RADIATION	R EY D IY EY SH AH N
PRAY	P R EY
CRYPTOLOGY	K R IH P T AA L AH JH IY
ACTUALLY	AE K CH UW AH L IY
ACTUALLY(2)	AE K CH L IY
ACTUALLY(3)	AE K SH AH L IY
NIFTY	N IH F T IY
PAD	P AE D
SAUCE	S AO S
GOOF	G UW F
RETURN	R IH T ER N
RETURN(2)	R IY T ER N
JARDANUP	JH AA R D AH N AH P
FOOD	F UW D
SALAMANDER	S AE L AH M AE N D ER
ANTICIPATED	AE N T IH S AH P EY T AH D
ANTICIPATED(2)	AE N T IH S AH P EY T IH D
PEGASUS	P EH G AH S AH S
VOMIT	V AA M AH T
INCEPTION	IH N S EH P SH AH N
NINJA	N IH N JH AH
ANDROID	AE N D R OY D
ERECTION	IH R EH K SH AH N
PREGNANT	P R EH G N AH N T
MATHEMATICIAN	M AE TH AH M AH T IH SH AH N
KAYAKING	K AY AE K IH NG
MICRO	M AY K R OW
MORONIC	M AO R AH N AH K
DIFFICULT	D IH F AH K AH L T
NICOTINE	N IH K AH T IY N
BIONIC	B AY AO N IH K
EXORCIZE	IH G Z AO R S AY Z
EYELASH	AY L AE SH
FISH	F IH SH
IDEA	AY D IY AH
NUMERIC	N UW M EH R IH K
DEMOCRAT	D EH M AH K R AE T
CONNECT	K AH N EH K T
QUANTUM	K W AA N T AH M
ANARCHY	AE N ER K IY
NEANDERTHAL	N IY AE N D ER TH AO L
PSYCHOLOGY	S AY K AA L AH JH IY
BLACKS	B L AE K S
SNUBBING	S N AH B IH NG
TROOPER	T R UW P ER
ASS	AE S
PUN	P AH N
EXODUS	EH K S AH D AH S
CALZONE	K AE L Z OW N
FRIDAY	F R AY D IY
FRIDAY(2)	F R AY D EY
HORSE	HH AO R S
ALZHEIMER	AE L Z HH AY M ER
ALZHEIMER(2)	AA L T S HH AY M ER
PROXY	P R AA K S IY
IMAGINE	IH M AE JH AH N
BASH	B AE SH
MISOGYNY	M IH Z AH JH IH N IY
CREMATED	K R IY M EY T IH D
LAUNCH	L AO N CH
STAMPEDE	S T AE M P IY D
TERRIBLE	T EH R AH B AH L
AMERICAN	AH M EH R IH K AH N
ROCKNROLL	R AA K N R AH L
ANECDOTE	AE N IH K D OW T
CASTLE	K AE S AH L
APOCALYPSE	AH P AA K AH L IH P S
SACRIFICE	S AE K R AH F AY S
RADICAL	R AE D IH K AH L
GRINDELWALD	G R IH N D EH L W AH L D
DEJAVU	D AH JH AE V UW
TOT	T AA T
MIST	M IH S T
GLITTER	G L IH T ER
GUESS	G EH S
JEW	JH UW
SCRIPT	S K R IH P T
INTRODUCTION	IH N T R AH D AH K SH AH N
INTRODUCTION(2)	IH N T R OW D AH K SH AH N
AUTOMOBILE	AO T AH M OW B IY L
FLIMSY	F L IH M Z IY
COMMINICATE	K AH M IH N IY K EY T
PHILANTHROPY	F IH L AE N TH R AH P IY
WONDERFUL	W AH N D ER F AH L
SCHEME	S K IY M
BANANA	B AH N AE N AH
MUGGERS	M AH G ER Z
OPTION	AA P SH AH N
OPTION(2)	AO P SH AH N
RELATIONSHIP	R IY L EY SH AH N SH IH P
OMELETTE	AA M AH L EH T
HOTEL	HH OW T EH L
JETLAGGED	JH EH T L AE G D
RETARD	R IH T AA R D
RETARD(2)	R IY T AA R D
SARKOZY	S AA R K AH Z IY
BOREDOM	B AO R D AH M
TRANSLATION	T R AE N Z L EY SH AH N
TRANSLATION(2)	T R AE N S L EY SH AH N
OBAMA	OW B AA M AH
KING	K IH NG
ARISTOCRACY	EH R AH S T AA K R AH S IY
YOUTH	Y UW TH
BRIDE	B R AY D
UTOPIA	Y UW T OW P IY AH
BOHEMIAN	B OW HH IY M IY AH N
DANK	D AE NG K
EXECUTIONER	EH K S AH K Y UW SH AH N ER
PHOBIA	F OW B IY AH
PEDESTRIAN	P AH D EH S T R IY AH N
ANTARCTICA	AE N T AA R K T IH K AH
ANTARCTICA(2)	AE N AA R T IH K AH
CARESS	K ER EH S
GRAFFITI	G R AH F IY T IY
BALLERINA	B AE L ER IY N AH
NIGHTS	N AY T S
REFUTE	R IH F Y UW T
LIN	L IH N
HETEROSEXUAL	HH EH T ER OW S EH K SH UW AH L
INTERNAL	IH N T ER N AH L
BANJO	B AE N JH OW
FOREMAN	F AO R M AH N
PLAY	P L EY
ELECTRIC	IH L EH K T R IH K
CHART	CH AA R T
CIGARETTE	S IH G AH R EH T
BROOKLYN	B R UH K L AH N
BROOKLYN(2)	B R UH K L IH N
ALPHA	AE L F AH
PRESTIGE	P R EH S T IY ZH
OMAHA	OW M AH HH AA
CHRONICLE	K R AA N IH K AH L
WINDOWS	W IH N D OW Z
OPAQUE	OW P EY K
TONGS	T AA NG Z
TONGS(2)	T AO NG Z
CACHING	K AE SH IH NG
VELOCITY	V AH L AA S AH T IY
ORGANISM	AO R G AH N IH Z AH M
GOLF	G AA L F
GOLF(2)	G AO L F
SPARROW	S P EH R OW
WASTED	W EY S T AH D
WASTED(2)	W EY S T IH D
BOOZE	B UW Z
ALERT	AH L ER T
STALKER	S T AO K ER
BRAHMAN	B R AE M AH N
GIANT	JH AY AH N T
SECALE	S AH K EY L
NORTHERN	N AO R DH ER N
ANVIL	AE N V AH L
FLESH	F L EH SH
PARANOIA	P EH R AH N OY AH
STRIPTEASE	S T R IH P T IY Z
SACRILEGE	S AE K R AH L AH JH
EMAIL	IY M EY L
CASSETTE	K AH S EH T
CONDOM	K AA N D AH M
CIRCLE	S ER K AH L
DARWIN	D AA R W IH N
SCHNAUZER	SH N AW Z ER
LOMBARD	L AA M B AA R D
EXECUTIVE	IH G Z EH K Y AH T IH V
BABBLE	B AE B AH L
EXPRESS	IH K S P R EH S
CAPSULE	K AE P S AH L
NOSTAGLIA	N AA S T AE G L IY AH
BREAST	B R EH S T
PELLET	P EH L AH T
HIM	HH IH M
HIM(2)	IH M
ENEMY	EH N AH M IY
ALCHOHOL	AE L CH AH HH AH L
HYPE	HH AY P
ART	AA R T
BOZO	B OW Z OW
SEX	S EH K S
CULTURE	K AH L CH ER
LION	L AY AH N
DUMB	D AH M
BARD	B AA R D
SEA	S IY
TENDER	T EH N D ER
ORIGAMI	AO R IY G AA M IY
CHEERIOS	CH IH R IY OW S
ANALOG	AE N AH L AO G
RITZ	R IH T S
EXPERT	EH K S P ER T
FICTICIOUS	F IH K T IH K S IY AH S
MILWAUKEE	M IH L W AO K IY
PLYWOOD	P L AY W UH D
ARCHITECT	AA R K AH T EH K T
KANGAROO	K AE NG G ER UW
PISS	P IH S
EUROPE	Y UH R AH P
STAGNATION	S T AE G N EY SH AH N
LATIN	L AE T AH N
SILICONE	S IH L AH K OW N
OUTFIT	AW T F IH T
TACOMA	T AE K AH M AH
OSBORN	AO Z B AO R N
THOT	TH AA T
CAPELLA	K AH P EH L AH
BLAZED	B L EY Z D
FRATERNITY	F R AH T ER N AH T IY
FRATERNITY(2)	F R AH T ER N IH T IY
RETARDED	R IH T AA R D IH D
RETARDED(2)	R IY T AA R D AH D
RETARDED(3)	R IY T AA R D IH D
COORIDOR	K OW OW R AH D ER
ELLIOT	EH L IY AH T
BRIDGE	B R IH JH
RECYCLING	R IY S AY K AH L IH NG
RECYCLING(2)	R IY S AY K L IH NG
GYPSY	JH IH P S IY
FROSTY	F R AO S T IY
LINUS	L AY N AH S
EYEWITNESS	AY W IH T N AH S
BEAGLE	B IY G AH L
JAVA	JH AA V AH
DUB	D AH B
JCREW	JH K R UW
ADD	AE D
STRATEGY	S T R AE T AH JH IY
REDUCTION	R IH D AH K SH AH N
DAMN	D AE M
AMNESIA	AE M N IY ZH AH
CHOKESLAM	CH OW K S L AE M
BRICK	B R IH K
MEETING	M IY T IH NG
DIALOGUE	D AY AH L AO G
FLIGHT	F L AY T
SQUIRREL	S K W ER AH L
GAY	G EY
FIRE	F AY ER
FIRE(2)	F AY R
CITIZEN	S IH T AH Z AH N
CITIZEN(2)	S IH T IH Z AH N
LOGJAM	L AA G JH AE M
GAG	G AE G
FUNK	F AH NG K
EVANGELICAL	IY V AE N JH EH L IH K AH L
FUR	F ER
FROZEN	F R OW Z AH N
BILL	B IH L
HOLOCAUST	HH AO L AH K AO S T
GOVERNOR	G AH V ER N ER
FUN	F AH N
ANIMATED	AE N AH M EY T IH D
MOUSTACHE	M AH S T AE SH
COLOANE	K OW L OW N
INCOGNITO	IH N K AO G N IY T OW
CONSTIPATED	K AA N S T AH P EY T AH D
AGITATION	AE JH AH T EY SH AH N
LYNETTE	L AY N EH T
LYNETTE(2)	L IH N EH T
CALCULATOR	K AE L K Y AH L EY T ER
PALMITATE	P AE L M AY T AH T
CONFOUND	K AA N F AW N D
CONFOUND(2)	K AH N F AW N D
TERMINATOR	T ER M AH N EY T ER
TRIPLE	T R IH P AH L
CHASM	K AE Z AH M
FAMICOM	F AE M AH K AH M
FUNNY	F AH N IY
DECOR	D IH K AO R
DECOR(2)	D EY K AO R
SHIRT	SH ER T
OPEN	OW P AH N
GRANT	G R AE N T
BONNIE	B AA N IY
SUBLIMINAL	S AH B L IH M IH N AH L
EXTRAVAGANZA	EH K S T R AE V AH G AE N Z AH
RUTH	R UW TH
WARUI	W AE R UW
LITERATURE	L IH T ER AH CH ER
CAPPUCINO	K AE P Y UW S AH N OW
CARTRIDGE	K AA R T R AH JH
CARTRIDGE(2)	K AA R T R IH JH
LEOPARD	L EH P ER D
YESTERDAY	Y EH S T ER D EY
YESTERDAY(2)	Y EH S T ER D IY
VIRGINIA	V ER JH IH N Y AH
MOMENT	M OW M AH N T
SANDALS	S AE N D AH L Z
BOURGEOIS	B UH R ZH W AA
LACROSSE	L AH K R AO S
EARMARK	IH R M AA R K
EARMARK(2)	IY R M AA R K
DATABASE	D EY T AH B EY S
DATABASE(2)	D AE T AH B EY S
ANALYSIS	AE N AE L IH S IH S
EDGE	EH JH
SWISS	S W IH S
ABSTAIN	AH B S T EY N
ABSTAIN(2)	AE B S T EY N
TELEGRAM	T EH L AH G R AE M
BEUR	B AH AH R
ATOMIC	AH T AA M IH K
ALTERNATIVE	AO L T ER N AH T IH V
CABARET	K AE B ER EY
AFRO	AE F R OW
LOADING	L OW D IH NG
TABLET	T AE B L AH T
BOTCH	B AA CH
STUDIOUS	S T UW D IY AH S
SPUTNIK	S P AH T N IH K
ACROBATICS	AE K R AH B AE T IH K S
EXCITED	IH K S AY T AH D
EXCITED(2)	IH K S AY T IH D
HATER	HH EY T ER
BIG	B IH G
BUREAUCRAT	B Y UH R AH K R AE T
BUREAUCRAT(2)	B Y UH R OW K R AE T
QUEST	K W EH S T
NARCISSIST	N AA R S IH S IH S T
BIT	B IH T
FORMAL	F AO R M AH L
DESERIALIZE	D IY S IH R IY AH L AY Z
NIPPLE	N IH P AH L
WALRUS	W AO L R AH S
ECOLOGY	IH K AA L AH JH IY
ECOLOGY(2)	IY K AA L AH JH IY
PIGLET	P IH G L IH T
FUCKING	F AH K IH NG
MAGNIFICENT	M AE G N IH F AH S AH N T
MAGNIFICENT(2)	M AE G N IH F IH S AH N T
HYPOCHONDRIAC	HH AY P AH K AA N D R IY AE K
CURIOUS	K Y UH R IY AH S
COCACOLA	K OW K AE K AH L AH
TSUNAMI	T S UW N AA M IY
TSUNAMI(2)	S UW N AA M IY
DEBRA	D EH B R AH
RELIGION	R IH L IH JH AH N
RELIGION(2)	R IY L IH JH AH N
STEW	S T UW
DATING	D EY T IH NG
EITHER	IY DH ER
EITHER(2)	AY DH ER
PATIENT	P EY SH AH N T
HYPOCRITICAL	HH IH P AH K R IH T IH K AH L
PERPENDICULAR	P ER P AH N D IH K Y AH L ER
COLONIZATION	K AA L AH N IH Z EY SH AH N
ZOMBIE	Z AA M B IY
EMPLOYABILITY	IH M P L OY IY AH B IH L AH T EH
FLUMP	F L AH M P
INFORMATICS	IH N F AO R M AE T IH K S
MEMORABILIA	M EH M ER AH B IY L Y AH
BY	B AY
BAFFLE	B AE F AH L
NETFLIX	N EH T L AH K S
GRADUATION	G R AE JH UW EY SH AH N
GRADUATION(2)	G R AE JH AH W EY SH AH N
DRAMA	D R AA M AH
MODAL	M OW D AH L
COCKBLOCK	K AA K B L AA K
SILENCE	S AY L AH N S
MAELSTROM	M EY L S T R AH M
REAL	R IY L
GARBAGE	G AA R B IH JH
TOFU	T OW F UW
SMELLY	S M EH L IY
VAGABOND	V AE G AH B AA N D
CHO	CH OW
LEBRON	L EH B R AH N
KATIE	K EY T IY
SONNY	S AH N IY
INFURIATING	IH N F Y UH R IY EY T IH NG
ARCADE	AA R K EY D
SPAM	S P AE M
QUESTION	K W EH S CH AH N
QUESTION(2)	K W EH SH AH N
FAST	F AE S T
ACCOUNTABILITY	AH K AW N T AH B IH L IH T IY
DOUBT	D AW T
BORED	B AO R D
MELODIC	M AH L AA D IH K
ARISE	ER AY Z
PEEPER	P IY P ER
INEPT	IH N EH P T
GLAMOUR	G L AE M ER
ATLANTIC	AH T L AE N T IH K
RUSSIAN	R AH SH AH N
DANGLE	D AE NG G AH L
APRICOT	EY P R AH K AA T
FRIES	F R AY Z
MOBILE	M OW B AH L
EBONICS	IY B AO N IH K S
UBER	UW B ER
FREAK	F R IY K
LABRADOR	L AE B R AH D AO R
LOSANGELES	L AA S AH N JH IY L Z
CHAN	CH AE N
ENGINEERING	EH N JH AH N IH R IH NG
CHAV	CH AE V
CODER	K OW D ER
ANCESTORS	AE N S EH S T ER Z
LEMON	L EH M AH N
PEACH	P IY CH
CODEX	K OW D EH K S
MALICIOUS	M AH L IH SH AH S
CATERPILLAR	K AE T AH P IH L ER
CATERPILLAR(2)	K AE T ER P IH L ER
GENOME	JH IY N OW M
DIMMER	D IH M ER
MANHATTAN	M AE N HH AE T AH N
MOCK	M AA K
EXPLAINING	IH K S P L EY N IH NG
FAVOURITE	F EY V ER IH T
DRAG	D R AE G
SQUIRM	S K W ER M
FLIRTATION	F L ER T EY SH AH N
DRAM	D R AE M
DRAM(2)	D IY R AE M
CHOCOLATE	CH AO K L AH T
TEXTED	T EH K S T IH D
SCOTCH	S K AA CH
KINETICS	K AH N EH T IH K S
SCREAM	S K R IY M
SOCRATES	S AA K R AH T IY Z
BEVERAGE	B EH V ER IH JH
BEVERAGE(2)	B EH V R IH JH
CORUNDUM	K ER AH N D AH M
IGNORAMUS	IH G N ER EY M AH S
FRESH	F R EH SH
YANK	Y AE NG K
BUFFALO	B AH F AH L OW
WATERGATE	W AO T ER G EY T
WATERGATE(2)	W AA T ER G EY T
RECEIVER	R AH S IY V ER
RECEIVER(2)	R IH S IY V ER
RECEIVER(3)	R IY S IY V ER
BABY	B EY B IY
PRIM	P R IH M
MOON	M UW N
KATE	K EY T
VIETNAMESE	V IY EH T N AA M IY S
DISPOSAL	D IH S P OW Z AH L
NOSE	N OW Z
OSTRACIZE	AO S T R AH S AY Z
HIPSTER	HH IH P S T ER
ENLIGHTENMENT	EH N L AY T AH N M AH N T
KAPUT	K AE P AH T
RAG	R AE G
STONEHENGE	S T OW N HH EH N JH
UKULELE	Y UW K AH L EY L IY
AUTOMOTIVE	AO T AH M OW T IH V
WAVE	W EY V
ELECTRON	IH L EH K T R AA N
FACEBOOK	F EY S B UH K
CELLULAR	S EH L Y AH L ER
NAVAJO	N AA V AH HH OW
NAVAJO(2)	N AE V AH HH OW
RECORDER	R IH K AO R D ER
RECORDER(2)	R IY K AO R D ER
MATERIALISM	M AH T IH R IY AH L IH Z AH M
TRI	T R AY
MAGIC	M AE JH IH K
MODULATOR	M AA JH AH L EY T ER
GENDER	JH EH N D ER
SHOCK	SH AA K
TRY	T R AY
GEOSPATIAL	JH IY AH S EY SH AH L
KNIFE	N AY F
OBESITY	OW B IY S AH T IY
OBESITY(2)	AH B IY S AH T IY
RACK	R AE K
THESPIAN	TH EH S P IY AH N
BOOTY	B UW T IY
FROST	F R AO S T
STONED	S T OW N D
DOTAGE	D OW T IH JH
BOOTS	B UW T S
CROOK	K R UH K
VIDEO	V IH D IY OW
PORNOGRAPHY	P AO R N AA G R AH F IY
ACID	AE S AH D
ODD	AA D
CLICK	K L IH K
FOLK	F OW K
INDEX	IH N D EH K S
CHICAGO	SH AH K AA G OW
EDIFICE	EH D AH F AH S
VAMPIRE	V AE M P AY R
AVALANCE	AH V EY L AH N S
INDIAN	IH N D IY AH N
EXERCISE	EH K S ER S AY Z
NACHO	N AE CH OW
NACHO(2)	N AA CH OW
LUTHERAN	L UW TH ER AH N
MELANCHOLY	M EH L AH N K AA L IY
EXCHANGE	IH K S CH EY N JH
NEWYORK	N Y UW AY AH R K
NITPICK	N IH T P IH K
BULIMIA	B Y UW L IH M IY AH
COMMERCIAL	K AH M ER SH AH L
EXPLORE	IH K S P L AO R
WEIRDO	W IH R D OW
HASBEEN	HH AA Z B IY AH N
SEXY	S EH K S IY
REMARK	R IH M AA R K
REMARK(2)	R IY M AA R K
METRO	M EH T R OW
AARDVARK	AA R D V AA R K
POPCORN	P AA P K AO R N
OPINION	AH P IH N Y AH N
GENE	JH IY N
MISCREANT	M IH S K R IY AH N T
SNIDE	S N AY D
CUCKOLD	K AH K OW L D
PRIVATE	P R AY V AH T
MOTOR	M OW T ER
LIME	L AY M
CRAP	K R AE P
REMAINS	R IH M EY N Z
REMAINS(2)	R IY M EY N Z
DOODLE	D UW D AH L
NEXT	N EH K S T
NEXT(2)	N EH K S
COUMARIN	K OW Y UW M AH R AH N
CAMERA	K AE M ER AH
CAMERA(2)	K AE M R AH
VEHICLE	V IY HH IH K AH L
VEHICLE(2)	V IY IH K AH L
CHIP	CH IH P
HALLOWEEN	HH AE L AH W IY N
TANGERINE	T AE N JH ER IY N
FUCK	F AH K
TRAIL	T R EY L
TRAIN	T R EY N
PENIS	P IY N IH S
PATHOS	P EY TH AA S
CHARITY	CH EH R IH T IY
ANIMALS	AE N AH M AH L Z
TUNNEL	T AH N AH L
ATHLETE	AE TH L IY T
RECESSION	R IH S EH SH AH N
RECESSION(2)	R IY S EH SH AH N
DONUT	D OW N AH T
THIN	TH IH N
MESOPOTAMIA	M EH S AH P AH T EY M IY AH
MEOW	M IY AW
THIRSTY	TH ER S T IY
CALCULATION	K AE L K Y AH L EY SH AH N
TAX	T AE K S
WOODLANDS	W UH D L AE N D Z
WOODLANDS(2)	W UH D L AH N D Z
TAN	T AE N
PAWS	P AO Z
SKIRT	S K ER T
RAPE	R EY P
EDUCATIONAL	EH JH AH K EY SH AH N AH L
EDUCATIONAL(2)	EH JH Y UW K EY SH AH N AH L
DEMOCRACY	D IH M AA K R AH S IY
BOXING	B AA K S IH NG
ANIMAL	AE N AH M AH L
COMEDY	K AA M AH D IY
INTELLIGENT	IH N T EH L AH JH AH N T
CIRCULAR	S ER K Y AH L ER
FARE	F EH R
ADMINISTRATOR	AH D M IH N IH S T R EY T ER
FART	F AA R T
FRAU	F R AW
FRAT	F R AE T
PRANCE	P R AE N S
TACO	T AA K OW
COMMUNICATOR	K AH M Y UW N AH K EY T ER
PSYCHEDELIC	S AY K AH D EH L IH K
TOMATO	T AH M EY T OW
TOMATO(2)	T AH M AA T OW
POCKET	P AA K AH T
SILETZ	S IH L AH T S
ROBOT	R OW B AA T
ROBOT(2)	R OW B AH T
ELEMENT	EH L AH M AH N T
SCOOP	S K UW P
ENCYCLOPEDIA	IH N S AY K L AH P IY D IY AH
ENCYCLOPEDIA(2)	IH N S AY K L OW P IY D IY AH
ROVE	R OW V
HEALTHCARE	HH EH L TH K EH R
FURIOUS	F Y UH R IY AH S
ADDICTION	AH D IH K SH AH N
MARTINI	M AA R T IY N IY
MUSTACHE	M AH S T AE SH
PROCRASTINATION	P R AH K R AE S T AH N EY SH AH N
ANTELOPE	AE N T AH L OW P
PRODUCER	P R AH D UW S ER
SPATULA	S P AE CH UH L AH
COSTUME	K AA S T UW M
MUTT	M AH T
HORNY	HH AO R N IY
WARREN	W AO R AH N
GLEN	G L EH N
INTERROGATIVE	IH N T AH R AA G AH T IH V
GRAFITTI	G R AH F IH T IY
EXCLUSION	IH K S K L UW ZH AH N
GLEE	G L IY
WINNING	W IH N IH NG
PERMANENT	P ER M AA N EH N T
DECAF	D IY K AE F
HOLIDAY	HH AA L AH D EY
HOLIDAY(2)	HH AA L IH D EY
PIXEL	P IH K S AH L
DAD	D AE D
VIOLATING	V AY AH L EY T IH NG
PYTHON	P AY TH AA N
MATERIAL	M AH T IH R IY AH L
INDEXING	IH N D EH K S IH NG
KISS	K IH S
REPUBLICAN	R IH P AH B L IH K AH N
REPUBLICAN(2)	R IY P AH B L AH K AH N
REPUBLICAN(3)	R IY P AH B L IH K AH N
DIABOLIC	D AY AH B AA L IH K
TRANSMITTER	T R AE N S M IH T ER
TESTICLE	T EH S T IH K AH L
FUZZ	F AH Z
NATIONALS	N AE SH AH N AH L Z
NATIONALS(2)	N AE SH N AH L Z
ILLUMINATE	IH L UW M IH N IH T
ILLUMINATI	IH L AH M IH N AH T IY
CHUNK	CH AH NG K
BLUETOOTH	B L UW T UW TH
AGGRAVATED	AE G R AH V EY T IH D
SOCIETY	S OW S AY IH T IY
FREQUENCY	F R IY K W AH N S IY
STATIC	S T AE T IH K
THIRTEEN	TH ER T IY N
IRRITATION	IH R IH T EY SH AH N
PROGRAMMER	P R OW G R AE M ER
SEXUAL	S EH K SH UW AH L
MAT	M AE T
PUERTORICAN	P Y UW EH R T AH R IH S AH N
MATT	M AE T
REY	R EY
MATRIX	M EY T R IH K S
ENTERTAINMENT	EH N T ER T EY N M AH N T
ENTERTAINMENT(2)	EH N ER T EY N M AH N T
ELECTRONICA	EH L AH K T R AA N AH K AH
BOUTIQUE	B UW T IY K
FASCIST	F AE SH IH S T
ACTIVIST	AE K T IH V IH S T
ARKANSAS	AA R K AH N S AA
HILARIOUS	HH IH L EH R IY AH S
ELECTRONICS	IH L EH K T R AA N IH K S
OBSESSIVE	AH B S EH S IH V
INTEGRATED	IH N T AH G R EY T AH D
INTEGRATED(2)	IH N T AH G R EY T IH D
INTEGRATED(3)	IH N AH G R EY T AH D
INTEGRATED(4)	IH N AH G R EY T IH D
MATH	M AE TH
TROOP	T R UW P
DICTIONARY	D IH K SH AH N EH R IY
PHARMACEUTICAL	F AA R M AH S UW T IH K AH L
INSINUATION	IH N S IH N Y UW EY SH AH N
GODLY	G AA D L IY
FOURTEEN	F AO R T IY N
SCARY	S K EH R IY
BACKWARDS	B AE K W ER D Z
WATERLOO	W AO T ER L UW
ISLAMIC	IH Z L AA M IH K
FLORIDA	F L AO R AH D AH
FLORIDA(2)	F L AO R IH D AH
FLORIDA(3)	F L AA R AH D AH
FLORIDA(4)	F L AA R IH D AH
YARN	Y AA R N
INTOXICATED	IH N T AA K S AH K EY T AH D
INTOXICATED(2)	IH N T AA K S IH K EY T IH D
NOTEBOOK	N OW T B UH K
WAITRESS	W EY T R AH S
PLAYSTATION	P L EY S T EY SH AH N
BLOGGER	B L AO G ER
JESUS	JH IY Z AH S
PUPPET	P AH P AH T
PUPPET(2)	P AH P IH T
BITCH	B IH CH
QUALITY	K W AA L AH T IY
LACOSTE	L AA K AO S T
ACCENT	AH K S EH N T
ACCENT(2)	AE K S EH N T
SYSTEM	S IH S T AH M
FORGERY	F AO R JH ER IY
VAGINA	V AH JH AY N AH
ANKLE	AE NG K AH L
JINGLE	JH IH NG G AH L
PAKISTANI	P AE K IH S T AE N IY
BEARD	B IH R D
TRAMPOLINE	T R AE M P AH L IY N
AGILITY	AH JH IH L AH T IY
GEAR	G IH R
PROSTITUTE	P R AA S T AH T UW T
SHORTS	SH AO R T S
EXACTLY	IH G Z AE K T L IY
HITCHING	HH IH CH IH NG
SLIDER	S L AY D ER
BIEBER	B IY B ER
BOTOX	B OW T AO K S
STEEL	S T IY L
PHOTOGRAPH	F OW T AH G R AE F
BEN	B EH N
SLACK	S L AE K
MORPH	M AO R F
HYSTERICAL	HH IH S T EH R IH K AH L
PHOTOGENIC	F OW T AH JH EH N IH K
INFECTIOUS	IH N F EH K SH AH S
BED	B EH D
FRUGAL	F R UW G AH L
LIGHT	L AY T
BARE	B EH R
WATERBOARDING	W AO T ER B OW R D IH NG
BISEXUAL	B AY S EH K SH UW AH L
WITTGENSTEIN	W IH T JH AH N S T IY N
WESTLAW	W EH S T L AO
KEENEY	K IY N IY
SKOKIE	S K OW K IY
BARK	B AA R K
SCREW	S K R UW
DALLAS	D AE L AH S
MONTGOMERY	M AA N T G AH M R IY
ADJUNCT	AE JH AH NG K T
NEGRO	N IY G R OW
LATINA	L AA T IY N AH
LATINA(2)	L AH T IY N AH
ASSHOLE	AE S HH OW L
TRIVIA	T R IH V IY AH
SOAP	S OW P
CENTRE	S EH N T ER
LACTATE	L AE K T EY T
PARENTING	P EH R AH N T IH NG
SATIRE	S AE T AY ER
HANDBAG	HH AE N D B AE G
COCKNEY	K AA K N IY
CLASS	K L AE S
CELLPHONE	S EH L F OW N
FANG	F AE NG
LANDSCAPING	L AE N D S K EY P IH NG
LANDSCAPING(2)	L AE N S K EY P IH NG
PAPERAZZI	P AE P AH R AA T S IY
BREE	B R IY
REQUEST	R IH K W EH S T
REQUEST(2)	R IY K W EH S T
THANKSGIVING	TH AE NG K S G IH V IH NG
SCRAMBLED	S K R AE M B AH L D
SNAPSHOT	S N AE P SH AA T
RENDEZVOUS	R AA N D IH V UW
BREW	B R UW
FACT	F AE K T
GORE	G AO R
ATMOSPHERE	AE T M AH S F IH R
TEXT	T EH K S T
TERMINATE	T ER M AH N EY T
DEMOCRATS	D EH M AH K R AE T S
REBUKE	R IY B Y UW K
REBUKE(2)	R IH B Y UW K
PORTFOLIO	P AO R T F OW L IY OW
FEAR	F IH R
ECONOMIST	IH K AA N AH M IH S T
ECONOMIST(2)	IY K AA N AH M IH S T
DEBATE	D AH B EY T
DECADE	D EH K EY D
SQUEEZE	S K W IY Z
DANDRUFF	D AE N D R AH F
KNOWLEDGE	N AA L AH JH
KNOWLEDGE(2)	N AA L IH JH
MARRIAGE	M EH R IH JH
LOCAL	L OW K AH L
EQUILIBRIUM	IY K W AH L IH B R IY AH M
HIJACKING	HH AY JH AE K IH NG
BEAT	B IY T
MICHIGAN	M IH SH IH G AH N
BEAR	B EH R
WIGGLE	W IH G AH L
AFOREMENTIONED	AH F AO R M EH N SH AH N D
GHETTO	G EH T OW
SMASH	S M AE SH
TOBACCO	T AH B AE K OW
COURSE	K AO R S
KORPELA	K ER P IY L AH
SHE	SH IY
VIEW	V Y UW
AVAILABLE	AH V EY L AH B AH L
CANINE	K EY N AY N
COMPUTER	K AH M P Y UW T ER
YUGOSLAVIA	Y UW G OW S L AA V IY AH
CYCLOTRON	S AY K L AH T R AA N
WONKA	W AO NG K AH
DESTINY	D EH S T AH N IY
LITERATI	L IH T ER AA T IY
LUX	L AH K S
PATTERN	P AE T ER N
CLOSED	K L OW Z D
HORRIBLE	HH AO R AH B AH L
EBOLA	IY B OW L AH
TELLYSCOPE	T EH L IY S K OW P
ADMIRATION	AE D M ER EY SH AH N
ZEITGEIST	T S AY T G AY S T
MASOCHISTIC	M AE S AH K IH S T IH K
ABILITY	AH B IH L AH T IY
CAULIFLOWER	K AA L AH F L AW ER
AMEN	EY M EH N
AMEN(2)	AA M EH N
KEG	K EH G
JOY	JH OY
ANTICS	AE N T IH K S
POLICE	P AH L IY S
PRECIOUS	P R EH SH AH S
PRAGMATICS	P R AE G M AE T IH K S
TITTIES	T IH T IY Z
TANTRUM	T AE N T R AH M
EMPATHY	EH M P AH TH IY
BACKBREAKER	B AE K B R EY K ER
GOAL	G OW L
DUMBLEDORE	D AH M B AH L D AO R
AQUA	AE K W AH
AQUA(2)	AA K W AH
TACTICAL	T AE K T IH K AH L
MECHANICS	M AH K AE N IH K S
SUBTITLE	S AH B T AY T AH L
WALL	W AO L
SATIATION	S EY SH IY EY SH AH N
INCEST	IH N S EH S T
NEWS	N UW Z
NEWS(2)	N Y UW Z
MONSTROSITY	M AA N S T R AA S AH T IY
CODDLE	K AA D AH L
LABOR	L EY B ER
AMIGO	AH M IY G OW
QUASISTELLAR	K W AA Z IY Z T EH L ER
SNORT	S N AO R T
HELLISH	HH EH L IH SH
HINDI	HH IH N D IY
PROPOSAL	P R AH P OW Z AH L
HOMOSEXUAL	HH OW M OW S EH K SH UW AH L
VINCE	V IH N S
ATLANTA	AE T L AE N T AH
PRESENT	P R EH Z AH N T
PRESENT(2)	P R IY Z EH N T
PRESENT(3)	P ER Z EH N T
VOLUNTEER	V AA L AH N T IH R
ABANDONED	AH B AE N D AH N D
INTIMIDATE	IH N T IH M IH D EY T
DIVORCE	D IH V AO R S
CHALK	CH AA K
CHALK(2)	CH AO K
FRAPPE	F R AE P
NAPIERIAN	N EY P IY R IY AH N
ARABIA	AH R EY B IY AH
PARTNER	P AA R T N ER
WHORE	HH AO R
TERRORIST	T EH R AH R IH S T
PRODUCTIVITY	P R OW D AH K T IH V AH T IY
PRODUCTIVITY(2)	P R OW D AH K T IH V IH T IY
PERHAPS	P ER HH AE P S
BALLOON	B AH L UW N
ADMINISTRATION	AE D M IH N IH S T R EY SH AH N
WEASLEY	W IY Z L IY
ROMANCE	R OW M AE N S
SPEAKER	S P IY K ER
GAMES	G EY M Z
TERRORISM	T EH R AH R IH Z AH M
FANATICS	F AH N AE T IH K S
MALAYA	M AH L EY AH
INFINITY	IH N F IH N IH T IY
ZIVA	Z IH V AH
DRINK	D R IH NG K
FUCKER	F AH K ER
BULLYING	B UH L IY IH NG
ROBOTIC	R OW B AA T IH K
PEDAL	P EH D AH L
WHALE	W EY L
WHALE(2)	HH W EY L
INDIGENOUS	IH N D IH JH AH N AH S
CATERPILLOR	K EY T ER P IH L ER
BROCCOLI	B R AA K AH L IY
BROCCOLI(2)	B R AA K L IY
MOSAIC	M OW Z EY IH K
DIABETES	D AY AH B IY T IY Z
SLAPHAPPY	S L AE P HH AE P IY
CELTIC	S EH L T IH K
CELTIC(2)	K EH L T IH K
WELD	W EH L D
FASCINATE	F AE S AH N EY T
RECORDS	R AH K AO R D Z
RECORDS(2)	R EH K ER D Z
RECORDS(3)	R IH K AO R D Z
NORTHBROOK	N AO R TH B R UH K
WEBLOG	W EH B L AA G
ENGLISH	IH NG G L IH SH
ENGLISH(2)	IH NG L IH SH
GLIAL	G L AY AH L
DRAWING	D R AO IH NG
ROCKER	R AA K ER
CAMEL	K AE M AH L
TENDERING	T EH N D ER IH NG
RECAP	R IY K AE P
RECAP(2)	R IH K AE P
MADDENING	M AE D AH N IH NG
MADDENING(2)	M AE D N IH NG
AFFLICTED	AH F L IH K T IH D
FLASHLIGHT	F L AE SH L AY T
WEB	W EH B
BIBLIOGRAPHY	B IH B L IY AA G R AH F IY
WINCHESTER	W IH N CH EH S T ER
PANTHER	P AE N TH ER
DRUNK	D R AH NG K
SKY	S K AY
CYBERNETIC	S AH B AH R N AH T AH K
NARCOLEPSY	N AA R K AH L EH P S IY
BOOK	B UH K
SKA	S K AA
CRACK	K R AE K
SANSKRIT	S AE N S K R IH T
SMART	S M AA R T
RAUBTIER	R AO B T AY AH R
BANQUET	B AE NG K W AH T
RUBIN	R UW B IH N
DESI	D EH Z IY
PRESS	P R EH S
KAREOKE	K AE R IY OW K
DOUGHNUT	D OW N AH T
PASSWORD	P AE S W ER D
MIAMI	M AY AE M IY
SOFA	S OW F AH
CLOWN	K L AW N
OZONE	OW Z OW N
SISSY	S IH S IY
VERITAS	V EH R AH T AH Z
VIRGINITY	V ER JH IH N IH T IY
TWITTER	T W IH T ER
LIBRARY	L AY B R EH R IY
HAIR	HH EH R
FRISBEE	F R IH S B IY
KABOOM	K AH B UW M
DRIZZLE	D R IH Z AH L
CAVALCADE	K AE V AH L K EY D
CORPSE	K AO R P S
DELAWARE	D EH L AH W EH R
HURRICANE	HH ER AH K EY N
HURRICANE(2)	HH AH R AH K EY N Z
MAGNITUDE	M AE G N AH T UW D
MUTATION	M Y UW T EY SH AH N
SWEEPSTAKES	S W IY P S T EY K S
SNUGGLE	S N AH G AH L
BIOLOGY	B AY AA L AH JH IY
ACRONYM	AE K R AH N IH M
ASTEROID	AE S T ER OY D
CELLULOSE	S EH L Y AH L OW S
SLUT	S L AH T
POMELO	P AA M AH L OW
PASTA	P AA S T AH
ANALYSER	AE N AH L AY Z ER
SISTER	S IH S T ER
UNIVERSE	Y UW N AH V ER S
BISCUIT	B IH S K AH T
TENDONITIS	T EH N D AH N AH T IY Z
DOCUMENTARY	D AA K Y AH M EH N T ER IY
DOCUMENTARY(2)	D AA K Y AH M EH N ER IY
DOCUMENTARY(3)	D AA K Y UW M EH N T ER IY
DOCUMENTARY(4)	D AA K Y UW M EH N ER IY
SOFTWARE	S AO F T W EH R
SOFTWARE(2)	S AO F W EH R
OWL	AW L
DEBUTANTE	D EH B Y AH T AA N T
PUSSY	P UH S IY
WASHINGTON	W AA SH IH NG T AH N
WASHINGTON(2)	W AO SH IH NG T AH N
COMMITMENT	K AH M IH T M AH N T
THREE	TH R IY
COCOA	K OW K OW
COCKER	K AA K ER
FEMALE	F IY M EY L
BOMBAY	B AA M B EY
JUBILEE	JH UW B AH L IY
ALPACA	AE L P AE K AH
TRANSFER	T R AE N S F ER
CINDERELLA	S IH N D ER EH L AH
WIMP	W IH M P
SLOVAKIA	S L OW V AA K IY AH
INTROVERT	IH N T R OW V ER T
CITRINE	S IH T R IY N
MANTEAU	M AE N T IY UW
MAZE	M EY Z
GLOBE	G L OW B
REPEATER	R IH P IY T ER
SHANK	SH AE NG K
HAZARDOUS	HH AE Z ER D AH S
SEQUEL	S IY K W AH L
BUT	B AH T
VOLUME	V AA L Y UW M
BRASSIER	B R AE S IY ER
BUM	B AH M
RECTUM	R EH K T AH M
EAR	IY R
EAR(2)	IH R
BUD	B AH D
DANGEROUS	D EY N JH ER AH S
LOONIE	L UW N IY
FLIP	F L IH P
DISTRACT	D IH S T R AE K T
INJUN	IH N JH AH N
FAGGOT	F AE G AH T
ZEBRA	Z IY B R AH
SKATING	S K EY T IH NG
MENSTRUATION	M EH N S T R UW EY SH AH N
PIN	P IH N
SWEETHEART	S W IY T HH AA R T
EDUCATION	EH JH AH K EY SH AH N
EDUCATION(2)	EH JH Y UW K EY SH AH N
DRACO	D R EY K OW
DRACO(2)	D R AE K OW
CHROMOSOME	K R OW M AH S OW M
CHROMOSOME(2)	K R OW M AH Z OW M
MUTUAL	M Y UW CH UW AH L
INCREDIBLE	IH N K R EH D AH B AH L
BOOP	B UW P
AGRICULTURE	AE G R IH K AH L CH ER
OFFENSIVE	AH F EH N S IH V
ILLINOIS	IH L AH N OY
ILLINOIS(2)	IH L AH N OY Z
DEBUTANT	D EY B Y UW AH N T
OTHER	AH DH ER
BOOM	B UW M
OBSESSED	AH B S EH S T
BOOB	B UW B
JUNK	JH AH NG K
REPEAT	R IH P IY T
REPEAT(2)	R IY P IY T
STAR	S T AA R
MONDAY	M AH N D IY
MONDAY(2)	M AH N D EY
JUNE	JH UW N
STAY	S T EY
ECOLOGICAL	IY K AH L AA JH IH K AH L
ECOLOGICAL(2)	EH K AH L AA JH IH K AH L
NINTENDO	N IH N T EH N D OW
AMBIDEXTROUS	AE M B IH D EH K S T R AH S
INSPIRATION	IH N S P ER EY SH AH N
GHOST	G OW S T
ALLOY	AE L OY
SASS	S AE S
FERTILIZE	F ER T AH L AY Z
BAKER	B EY K ER
RURAL	R UH R AH L
YELL	Y EH L
BUOY	B UW IY
ACTIVISM	AE K T IH V IH Z AH M
DEMODULATOR	D IY M AA JH UW L AH T ER
